species_name	Complete_BUSCOs	Complete_&_single-copy	Complete_&_duplicated	Fragmented	Missing	Total
Abeoforma_whisleri	651	623	28	49	254	954
Acanthoeca_spectabilis	698	473	225	47	209	954
Acropora_aculeus	928	716	212	9	17	954
Acropora_cervicornis	942	473	469	7	5	954
Acropora_digitifera	936	592	344	7	11	954
Acropora_millepora	867	696	171	57	30	954
Acropora_tenuis	924	680	244	11	19	954
Actinia_tenebrosa	906	788	118	22	26	954
Aegina_citrea	656	617	39	150	148	954
Agaricia_lamarcki	879	662	217	47	28	954
Alcyonium_palmatum	829	724	105	69	56	954
Alveopora_japonica	926	628	298	15	13	954
Amoebidium_parasiticum	740	615	125	32	182	954
Amphidiscella_abyssalis	329	299	30	231	394	954
Amphimedon_queenslandica	873	470	403	27	54	954
Anemonia_sulcata	919	750	169	20	15	954
Anemonia_viridis	881	717	164	40	33	954
Anthopleura_dowii	876	793	83	40	38	954
Anthopleura_elegantissima	934	766	168	10	10	954
Antipathes_caribbeana	900	723	177	28	26	954
Aplysina_aerophoba	841	523	318	32	81	954
Apolemia_lanosa	794	756	38	60	100	954
Atolla_vanhoeffeni	627	600	27	140	187	954
Aulacoctena_acuminata	750	699	51	42	162	954
Aulactinia_veratra	878	810	68	39	37	954
Aulocalyx_serialis	733	500	233	86	135	954
Aurelia_aurita	912	676	236	13	29	954
Axinella_polypoides	874	679	195	34	46	954
Baikalospongia_bacillifera	860	686	174	23	71	954
Bargmannia_amoena	761	714	47	81	112	954
Bargmannia_elongata	903	809	94	10	41	954
Bargmannia_lata	616	569	47	126	212	954
Bathocyroe_fosteri	803	706	97	17	134	954
Bathyctena_chuni	747	687	60	55	152	954
Beroe_abyssicola	796	710	86	24	134	954
Beroe_forskalii	793	662	131	25	136	954
Beroe_ovata	794	583	211	28	132	954
Bolinopsis_microptera	802	759	43	15	137	954
Bolosoma_cyanae	671	549	122	96	187	954
Branchiostoma_floridae	562	499	63	250	142	954
Calliactis_polypus	916	797	119	16	22	954
Calvadosia_campanulata	807	707	100	86	61	954
Calvadosia_cruxmelitensis	910	754	156	10	34	954
Capsaspora_owczarzaki	685	567	118	28	241	954
Caulophacus_discohexaster	702	509	193	85	167	954
Cestum_veneris	795	715	80	21	138	954
Charistephane_fugiens	624	586	38	117	213	954
Chaunoplectella_NIWA126325	657	405	252	124	173	954
Chelophyes_appendiculata	866	613	253	39	49	954
Chironex_fleckeri	798	743	55	67	89	954
Chondrosia_reniformis	848	649	199	26	80	954
Chrysaora_fuscescens	583	570	13	190	181	954
Chuniphyes_multidentata	844	738	106	43	67	954
Cinachyrella_alloclada	906	488	418	32	16	954
Clathrina_coriacea	617	509	108	212	125	954
Clavularia_sp	783	716	67	102	69	954
Cliona_varians	858	622	236	44	52	954
Coelastrea_aspera	938	663	275	6	10	954
Condylactis_gigantea	929	723	206	8	17	954
Copula_sivickisi	911	305	606	16	27	954
Corallium_rubrum	913	757	156	8	33	954
Corbitella_NIWA126123	235	214	21	219	500	954
Corticium_candelabrum	879	673	206	25	50	954
Corynactis_australis	914	702	212	19	21	954
Craseoa_lathetica	896	758	138	17	41	954
Craterolophus_convolvulus	689	490	199	174	91	954
Crella_elegans	744	564	180	111	99	954
Ctenactis_echinata	813	775	38	99	42	954
Ctenophora_sp_BWRF2014	804	741	63	22	128	954
Ctenophora_sp_CWRF2014	805	721	84	20	129	954
Ctenophora_sp_KWRF2015	821	766	55	16	117	954
Ctenophora_sp_L1WRF2015	815	650	165	27	112	954
Ctenophora_sp_L2WRF2015	804	727	77	20	130	954
Ctenophora_sp_MWRF2015	796	723	73	33	125	954
Ctenophora_sp_N1WRF2014	801	725	76	21	132	954
Ctenophora_sp_N2WRF2014	804	720	84	17	133	954
Ctenophora_sp_PWRF2015	818	695	123	21	115	954
Ctenophora_sp_TWRF2014	784	716	68	26	144	954
Ctenophora_sp_WWRF2014	795	689	106	27	132	954
Ctenophora_sp_XWRF2015	794	721	73	23	137	954
Cyanea_capillata	682	564	118	169	103	954
Cyanea_nozakii	893	788	105	19	42	954
Cymbastella_concentrica	877	728	149	29	48	954
Cyphastrea_serailia	784	424	360	115	55	954
Danio_rerio	931	885	46	9	14	954
Daphnia_pulex	923	658	265	12	19	954
Deiopea_kaloktenota	793	724	69	21	140	954
Dendrilla_antarctica	794	638	156	74	86	954
Dendronephthya_gigantea	909	654	255	11	34	954
Dendrophyllia_sp	917	766	151	14	23	954
Desmophyes_sp	893	797	96	19	42	954
Dipsastraea_rotumana	932	685	247	10	12	954
Dryodora_glandiformis	789	709	80	25	140	954
Dysidea_avara	894	537	357	21	39	954
Edwardsiella_carnea	935	614	321	7	12	954
Entacmaea_quadricolor	927	739	188	9	18	954
Ephydatia_fluviatilis	863	592	271	11	80	954
Ephydatia_muelleri	851	636	215	34	69	954
Erenna_richardi	890	808	82	19	45	954
Eucidaris_tribuloides	326	300	26	253	375	954
Eunicea_calyculata	918	742	176	10	26	954
Eunicella_cavolini	558	512	46	217	179	954
Euplokamis_dunlapae	806	750	56	27	121	954
Eurete_NIWA126276	759	645	114	47	148	954
Farrea_occa	750	654	96	57	147	954
Farrea_similaris	186	160	26	194	574	954
Favites_acuticollis	928	753	175	10	16	954
Forskalia_asymmetrica	877	808	69	29	48	954
Fungia_fungites	936	725	211	7	11	954
Galaxea_astreata	934	669	265	7	13	954
Geodia_atlantica	794	309	485	91	69	954
Geodia_hentscheli	740	622	118	118	96	954
Geodia_macandrewii	725	592	133	135	94	954
Geodia_phlegraei	762	607	155	99	93	954
Goniastrea_retiformis	863	754	109	51	40	954
Goniopora_columna	925	729	196	12	17	954
Gorgonia_ventalina	925	623	302	8	21	954
Grantia_compressa	857	635	222	22	75	954
Haeckelia_beehleri	803	751	52	17	134	954
Haeckelia_rubra	799	743	56	23	132	954
Halichondria_panicea	920	328	592	23	11	954
Haliclona_amboinensis	889	87	802	14	51	954
Haliclona_tubifera	861	536	325	24	69	954
Haliclystus_auricula	639	546	93	182	133	954
Halisarca_dujardinii	830	580	250	31	93	954
Helgoeca_nana	673	511	162	50	231	954
Heliopora_coerulea	909	638	271	23	22	954
Heteractis_crispa	931	742	189	8	15	954
Hippopodius_hippopus	904	741	163	11	39	954
Hoilungia_hongkongensis	906	750	156	12	36	954
Hormiphora_californensis	777	605	172	32	145	954
Hydra_oligactis	896	820	76	17	41	954
Hydra_viridissima	904	683	221	13	37	954
Hydra_vulgaris	914	831	83	13	27	954
Hydractinia_symbiolongicarpus	918	775	143	10	26	954
Ichthyosporea_XGB-2017a	726	582	144	38	190	954
Isodyctia_sp	878	639	239	18	58	954
Janusya_sp	655	597	58	164	135	954
Kiyohimea_sp_WRF2015	792	717	75	28	134	954
Lampea_lactea	746	676	70	61	147	954
Lampea_sp	802	742	60	19	133	954
Lampocteis_cruentiventer	799	749	50	23	132	954
Latrunculia_apicalis	749	698	51	67	138	954
Lendenfeldia_chondrodes	872	620	252	20	62	954
Leucetta_chagosensis	892	721	171	21	41	954
Leuconia_nivea	747	559	188	92	115	954
Leucothea_pulchra	797	723	74	23	134	954
Lilyopsis_fluoracantha	847	729	118	49	58	954
Liriope_tetraphylla	916	490	426	12	26	954
Lobactis_scutaria	851	697	154	65	38	954
Lobata_sp_VWRF2014	798	732	66	23	133	954
Lubomirskia_abietina	858	692	166	27	69	954
Lubomirskia_baikalensis	859	648	211	31	64	954
Lychnagalma_utricularia	874	796	78	29	51	954
Marrus_claudanielis	867	801	66	36	51	954
Megalactis_griffithsi	888	732	156	39	27	954
Millepora_alcicornis	917	795	122	11	26	954
Montastraea_cavernosa	903	789	114	24	27	954
Montipora_aequituberculata	941	719	222	4	9	954
Montipora_capitata	930	706	224	9	15	954
Montipora_digitata	947	373	574	2	5	954
Muricea_laxa	898	772	126	22	34	954
Mycale_cecilia	884	549	335	36	34	954
Mycale_phylophylla	806	656	150	68	80	954
Nanomia_bijuga	853	795	58	49	52	954
Nematostella_vectensis	917	732	185	8	29	954
Nemopilema_nomurai	911	795	116	11	32	954
Neopetrosia_compacta	895	569	326	13	46	954
Ocyropsis_maculata	772	610	162	51	131	954
Oligometra_serripinna	933	833	100	5	16	954
Oscarella_lobularis	851	485	366	25	78	954
Oscarella_pearsei	873	631	242	17	64	954
Palythoa_caribaeorum	909	786	123	22	23	954
Palythoa_variabilis	858	748	110	56	40	954
Pelagia_noctiluca	907	805	102	15	32	954
Petrosia_ficiformis	893	540	353	24	37	954
Phenganax_sp	890	611	279	38	26	954
Physalia_physalis	864	816	48	42	48	954
Plakina_jani	881	735	146	26	47	954
Platynereis_dumerilii	928	718	210	8	18	954
Pleraplysilla_spinifera	883	641	242	15	56	954
Plesiastrea_versipora	908	735	173	24	22	954
Plumapathes_pennacea	925	747	178	8	21	954
Pocillopora_damicornis	944	451	493	5	5	954
Poecilosclerida_sp	668	573	95	153	133	954
Porites_astreoides	898	747	151	30	26	954
Porites_australiensis	928	743	185	12	14	954
Porites_lobata	926	747	179	11	17	954
Porites_lutea	934	715	219	9	11	954
Priapulus_caudatus	882	676	206	44	28	954
Protopalythoa_variabilis	858	757	101	54	42	954
Pseudodiploria_strigosa	923	649	274	18	13	954
Pseudospongosorites_suberitoides	391	358	33	241	322	954
Ptychodera_flava	950	190	760	2	2	954
Regadrella_okinoseana	781	604	177	46	127	954
Resomia_ornicephala	893	812	81	19	42	954
Rhizophysa_filiformis	889	807	82	21	44	954
Rhodactis_indosinensis	928	743	185	8	18	954
Rossellidae_NIWA126310	659	499	160	106	189	954
Saccocalyx_tetractinus	343	312	31	221	390	954
Salpingoeca_infusionum	672	501	171	48	234	954
Sarcothelia_edmonsoni	899	669	230	20	35	954
Sarcotragus_fasciculatus	595	477	118	200	159	954
Scopalina_sp	803	703	100	66	85	954
Seriatopora_hystrix	653	530	123	191	110	954
Siderastrea_siderea	933	706	227	9	12	954
Sinularia_cruciata	803	727	76	91	60	954
Spongia_officinalis	893	403	490	32	29	954
Spongilla_lacustris	872	647	225	31	51	954
Stephalia_dilata	881	800	81	21	52	954
Stephalia_sp	793	757	36	79	82	954
Stichodactyla_haddoni	793	668	125	111	50	954
Stichodactyla_helianthus	859	784	75	57	38	954
Stomolophus_meleagris	793	751	42	75	86	954
Strongylocentrotus_purpuratus	926	736	190	6	22	954
Sycon_ciliatum	815	686	129	46	93	954
Sycon_coactum	310	275	35	245	399	954
Symsagittifera_roscoffensis	796	706	90	23	135	954
Tedania_anhelans	833	621	212	43	78	954
Tethya_wilhelma	880	568	312	13	61	954
Thalassocalyce_inconstans	786	712	74	27	141	954
Trichoplax_adherens	911	731	180	10	33	954
Tripedalia_cystophora	913	743	170	15	26	954
Trychella_NIWA126306	710	605	105	74	170	954
Tubastraea_coccinea	946	254	692	5	3	954
Tubipora_musica	884	810	74	30	40	954
Tubulanus_polymorphus	867	830	37	48	39	954
Turritopsis_sp	737	667	70	65	152	954
Vaceletia_crypta	708	565	143	146	100	954
Velamen_paralellum	803	458	345	21	130	954
Walteria_leuckarti	620	368	252	171	163	954
Xenia_sp	879	785	94	35	40	954
Xenoturbella_bocki	893	670	223	16	45	954
Xestospongia_testudinaria	540	398	142	236	178	954
